10 15
...............
..X............
X.X............
.XX............
...............
...............
...............
..........X....
........X.X....
.........XX....