16 15
...............
...............
...............
...............
...........X...
........X..X...
........XXXX...
.........X.....
...............
...............
...............
...............
...............
..........X....
........X.X....
.........XX....