.................
.................
.................
.................
.................
..........X.X....
.......XX.X.X....
.......XXXXX.....
.................
.................
.................
.................
.................
.................
.........X.X.....
..........XX.....
..........X......
.................
