15 15
...............
...............
.X.............
.XXX...........
...XXX.........
...X.X.X.......
.....XX........
.....X.........
...............
...............
...............
...............
...............
...............
...............
