10 15
...............
...............
....X..........
.....X.........
...XX.XXX......
.......X.......
........X......
...............
...............
...............
