1111111011
1101110111
1101110101
1000111110
1010111111
0000111011
1011001111
0000010111
